11111111111
1EP000W0111
10101000011
10100W00011
11000000011
10000C00011
10000000001
10000100111
10101001011
11111111111
