1111111111111111111111111
10000W0000000000000CCC001
101010C0000000000000WWW11
1000000000CWWWCWCWC000001
1000110000111111111111111
10000000000000000000C0C11
1000000000000000000000C11
10000000000E0000000000C11
1000000000000000000000C11
1000000P00000000000000C11
1000000000000000000000C11
1000000000000000000000C11
1000000000000000000000C11
1111111111111111111111111
