11111111111
1E000W0P111
101010C0011
10000000001
10001100001
11111111111
